 縣市別	代碼 
 臺北市	 A
 臺中市	 B
 基隆市	 C
 臺南市	 D
 高雄市	 E
 新北市
(臺北縣)  F
 宜蘭縣	 G
 桃園縣	 H
 新竹縣	 J
苗栗縣	K
臺中縣	L
南投縣	M
彰化縣	N
雲林縣	P
嘉義縣	Q
臺南縣	R
高雄縣	S
屏東縣	T
花蓮縣	U
臺東縣	V
澎湖縣	X
陽明山	Y
金門縣	W
連江縣	Z
嘉義市	I
新竹市	O